+++++++++
+ 0   AA+
+  AAAAA+
+  AAAAA+
+ AAAAAA+
+ AAAAAa+
+++++++++