++++++++++++++++++++++++
++                     +
+0 + + + + + + + + + + +
++                     +
++++ +++++++++++++++ + +
++++ +++               +
++++ +++++++++++++++ + +
++++ +++               +
++++ +++++++++++++++ + +
++++++++++++++++++++++ +
+                    + +
++A+ + + + + + + + +   +
+a                     +
++++++++++++++++++++++++