+++++++++++++++++++++++++++++++++++++++++++++++++++++++++++++
+a  +               +             +               +         +
+++ + + +++++++++++ + +++++++++++ +++ +++ +++++++++ +++++++ +
+A+ + +     +   +   +       +         + +           +       +
+ + +++++++ + + + + +++++++ +++++++++++ + +++++++++++ +++++++
+ +         + + + + +             +   + + +   +   +   +     +
+ +++++++++++ + + + + +++++++++++ + +++ + + + + + + +++ +++++
+     +     + + + + + +       + + +     + + + + + + +       +
+++++ +++ +++ + + + + + +++++++ + +++ + + + + + + + + +++++ +
+       + +   +   + + +       + + +   +   + +   + + + +   + +
+ +++ + + + +++++++ + +++ +++ + + + +++++++ +++++ + + + + + +
+ + + + +   +     + +   +   + + + +     +   +     +     + + +
+ + + +++++ + +++ + + + +++ + + + +++++ + +++ +++++ +++++ + +
+   +     + + +   + + + +   +   + +   + +   +       +   + + +
+++++++++ + + + +++ + + + +++ + + + + + +++ +++++++++ + + + +
+       + + + +     + + +   + + + + +   + + +       + +   + +
+ +++++ + + + +++++++++ +++ + +++ +++++++ + + +++ +++ +++++ +
+ +   + + + + + +       +   +     +     + + + +     +   +   +
+ +++ + + + + + + +++++ + +++++++++ + +++ + + + +++++++ + + +
+   + + +   + +   +     + +       + +     + + +         + + +
+ + + + +++++ + + +++++++ + +++ + + +++++ + + +++++++++++ + +
+ + + +       + +     +   +   + + + +   + + + +   +     + + +
+ + + +++++++++++++++ + +++++++ + + +++ + + + + + + +++ + +++
+ + +               + +         + +     +   +   + + +   +   +
+ + + +++ +++++++++++ +++++++++++ +++++ +++++++++++ + +++ + +
+ + + +   +           +         + +   +             + +   + +
+ + +++ +++ +++++++++++ +++++++ + + + +++++++++++++ + +++++ +
+ + +   +   +         +   +     + + + +           + + +   + +
+ + + +++ +++ +++++++++++ + +++++ + + + +++++++ + + + + + + +
+ + + +   +             + +       + + + +     + + + +   + + +
+ + + + +++++++++++++++ + +++++++++++ + + +++ + + + +++++++ +
+ + +           +       + +         +   + + +   + + +     + +
+ + +++++++++++ + +++++ + + +++++++ + + + + +++++ + + + + + +
+ +             +   +   + +       + + + + + +     + + + + + +
+ +++++++++++++++++ + +++ +++++++ + +++ + + + +++++ + +++ + +
+ +   +       +     +             +   + +   + +     +   + + +
+ + + +++ +++ + +++++ +++++++++++++++++ +++++ + +++++++ + + +
+ + +     +   + +     +                 +   + + + +     + + +
+ + +++++++ +++ +++++++ +++++++++++++++++ + + + + + +++++ + +
+ + +   +   + + +       +         +     + + + +   + +     + +
+ + + + + +++ + + +++++++++++++ + + +++ + + + +++++ +++++ + +
+ +   + +     + + +           + + + + + + +   +     +   + + +
+ +++++ +++++ + + + +++ +++++ + + + + + + +++ + +++++ + + + +
+       +   + + + +   +     + + + + + + +   + + +   + + + + +
+++++++++ + + + + +++++++++ + + +++++ + +++ + + + + + + + + +
+       + + + + +           + +       +   + + + + + + + + + +
+ +++++ + + + + +++++++++++++ +++++ + + +++ + + + +++ + + + +
+     +   + + +               +   + + +     + + +     + + + +
+++++ +++++ +++++++ +++++++++++ + +++ +++++++ + +++++ + + + +
+   + +   +       + + +       + +             +       + + + +
+ + + + + +++++++ + + + +++++ + +++++++++++++++++++++++ + + +
+ +   + + +     +   + + +     + +                       + + +
+ +++++ + + +++ +++++ + + +++++ + +++++++++++++++++++++++ + +
+ +     + + +     + +   +       +     +     +       +     + +
+ + +++++ + +++++ + + + +++++++++++++ + +++ + +++++ +++++ + +
+ + +     + +   + +   +             + + +   +     +       + +
+ + +++ +++ + + +++++++++++++++++++ + + + +++++++ +++++++++ +
+ +   + +     +         +         +   + + +   + +         + +
+ +++ + +++++++++++++++ +++++++++ +++++ + + + + +++++++++ +++
+     +                                 +   +           +  0+
+++++++++++++++++++++++++++++++++++++++++++++++++++++++++++++
